10000000000000000000
11111111111111111111
11111111111111111111
11123111111111111111
11111111111111111111
11111111111111111111
11111111111111111111
11111111111111111111
11111111111111111111
11111111111111111111
11111111111111111111
11111111111111111111
11111111111111111111
10000000000000000000
10000000000000000000