22222233322111111111
22212223321100011111
22211221113110002333
11213131333311121111
11233131001332221111
11231131311111300111
01223231111233300011
00220000333333333000
00331100001111321111
00311111101111221000
00331110001111332000
11233112111113311222
11213210001111111111
22211211100000011111
22222222221110000011