11000000000111111111
11111223110001111111
11111133331100001111
11113131333311101111
11133131111332221111
11131131311111301111
01133231222233300011
00030000333333333000
11331100001111321111
11311111101111221111
11331110001111111111
11133110111113111111
11113210001111111111
11111211100000011111
11111111111110000011
